Date,Moses Thulare Moshwane,Nkosingiphile Ntombikayise Ntombi Khumalo,Ntombizodwa Zodwa Dubazana,Gilda Katarina Mashele,Total
01-Oct-25,0,0,0,0,0
06-Oct-25,30,16,77,0,123
07-Oct-25,37,45,109,0,191
08-Oct-25,45,34,109,0,188
09-Oct-25,40,75,98,10,223
10-Oct-25,33,72,105,0,210
11-Oct-25,1,0,0,2,3
13-Oct-25,0,58,100,0,158
14-Oct-25,0,59,104,0,163
15-Oct-25,3,35,64,0,102
